11111111111111111
10CC000P1E0000001
10111111111111101
101000CCC000100C1
10101111111010111
101010C01C0010001
1010101010111C101
10101010100C11101
10101010111010001
10100C101C00101C1
101C1110101110111
101C1000100C100C1
1011101C111011101
10CCC01C1CC000001
11111111111111111
