1111111111111111111111111111111111111111111111111
10C010C0100000CCCCCCCCC001000CCCCCCCCC0001000CC01
101010101000111111111111111011111111111100010CC01
10101010100010C0C0C0C0C0C0C0C0C0C0C0C00100010CC01
1C10C01010001C11111111111111111111111101C1C1000P1
101111101000101000CCCCCCCCCCCCCCC0000101C1C111111
1C10CC0010001C10111111111111111111110101C1C10CC01
101011111000100000000000000000000000010100010CC01
1C101C100000111111111111111111111111110110010CC01
1E10CC0000000000000000000000000000000000C10000001
1111111111111111111111111111111111111111111111111
