111111111111111
1CCC1000001CCC1
101010111010101
1010101C1010101
1010101C1010101
1010101C1010101
101C1010101C101
101C10100010101
101C10101010101
10101010101C101
1010101C1010101
101P101C1010101
1011101C1010101
1000001C10C01E1
111111111111111
