11111111111111111111111111111111111
1P000011000CCC000000000000010CCCC01
1111101C0010CC010C011110C0010CCCC01
100010000010CC010010CC0100010111111
10101000001111110000001000010100001
101000000000C0C100001C0C00000101001
1011111111110C010011111100011101CC1
1CCCCCCCCCC10C000000000000000001CE1
11111111111111111111111111111111111
