111111111111
1PC01CC0C001
101011101101
1C10CC101C01
1C1011101101
101C10001C01
101C10111101
1C1010CCC101
1010101111C1
1010101E1101
10000010C001
111111111111
