111111111111111111
100000010000001E01
100111010010101101
111101010010100001
100001011110110111
1P1000000000100001
111111111111111111
