111111111111111111
1CCCCC010000001E01
1CC11101CC10101101
11110101CC10100001
100001011110110111
1P10000E00001CCCC1
111111111111111111
